NO ./srcs/parser/init.c
SO ./srcs/parser/init.c
WE ./srcs/parser/init.c
EA ./srcs/parser/init.c

F 220,100,0
C 225,30,0


11111111111111111111111111
100000000000000000000000011111111
10000000S000000000000000001111111
111111111111111111100000000111111
10000000000000000000000011111
11111111111111111111111011111
                      1011111
                      1011111
11111111111111111111111000001
10000000000000000000000011111
10000000000000000000000011111
1111111111111111111111111