NO ./sprites/pote_c.xpm 
SO ./sprites/morita.xpm
WE ./sprites/gyokers.xpm
EA ./sprites/porro_c.xpm


C 146, 222, 247
F 242, 179, 119




        1111111111111111111111111
        1000000000110000000000001
        1011000001110000000000001
        1001000000000000000000001
111111111011000001110000000000001
100000000011000001110111111111111
111101111111111111000000000011
11110111111111 1011100010010001
110000001101011111000000100011
10000000000000001100000010001
1000000000000001101010010001
11000001111111111111011110N0111111
11110111       1110101 1011110100011
11111111 1111111 111111111111111111
