11111111
10000001
11111001
10000001
10S00001
10100001
10000001
11111111