NO ./sprites/north_wall
SO ./sprites/south_wall
WE ./sprites/west_wall
EA ./sprites/east_wall

F 220,100,0
C 225,30,0

               11111111111111111111111111111
               10000000000000000000000000001
               10000000000000000000000000001
               10000000000000000000000000001
    1111111111110000000000000000000000000001
    1000000000000000000000000000000000000011
1111100000000000000000000000000000000000011
100000000000000000000000000000000000000001
100000000000000000000000000000000000000001
100000001  1000000001 10000001 10000000001
100000001  1000000001 10000001 10000000001
111111111  1111111111 11111111 11111111111